NO ./texture/floor.xpm
SO ./texture/floor.xpm
WE ./texture/planks.xpm
EA ./texture/planks.xpm

F 135,253,0
C 34,170,200




        1111111111111111111111111
        1000000000011000000000001
        1011000001110000000000001
        1001000000000000010000001
111111111011000001110000000000001
100000000000000011101111111111111
111101111111110111000000100011111
11110111  11110111010100100011111
110000011101010111000000100011111
100000000000000000000000000000001
100000000000000011010100100011111
110000011101010111110111100W1
11110111 1110101 101111010001
11111111 1111111 111111111111