NO ./path_to_the_north_texture
SO ./path_to_the_south_texture
WE ./path_to_the_west_texture
EA ./path_to_the_east_texture

F 250,150,12
C 255,30,150




111111111111111111111111111111111
111111111000000000011000000000001
111111111011000001110000000000001
111111111001000000000000010000001
111111111011000001110000000000001
100000000110000011101111111111111
111101111111110111000000100011111
111101111111110111010100100011111
110000011101010111000000100011111
100000000000000110000001000000001
100000000000000011010100100011111
11000001110101011111011110W011111
11110111 1110101 1011110100011111
11111111 1111111 1111111111111111