        1111111111111111111111111
        1000000000011000000000001
        1011000001110000000000001
        1001000000000000000000001
111111111011000001110000000000001
1000000000110000011101111111111111
11110111111111011100000010001
11110111111111011101010010001
110000001101010111000000100011111
1000000000000000110000001000000001
100000000000000011010100100011111
1100000111010101111101111000111
11110111 1110101 101111010001
11111111 1111111 111111111111