NO ./texture/bricks.xpm
SO ./texture/planks.xpm
WE ./texture/gravel.xpm
EA ./texture/tilledsoil.xpm

F 60,48 ,48
C 3,34,76



        11111111111111111111111111111111111111111111111111111
        10000000000110000000000000000000000000000000000000001
        10110000011100000000000000000000000000000000000000001
        10010000000000000100000011111111111111111000000000001
1111111110110000011100000000000011111111111111111000000000001
100000000000000011101111111111111           11111000000000001
111101111111110111000000100011111           10000000000000001
11110111  11110111010100100011111           11111111011111111
110000011101010111000000100011111                  101   
100000000000000000000000000000001                  101   
100000000000000011010100100011111                  101
11000001110101011111011110001                      101   
11110111 1110101 111111110001                      101   
11111111 1110111 111111110001               11111111011111111
           101          10001               10000000000000001
           10111111111111000111111111111111110000000000000001
           10100000000000000000000000000000000000000000000001
           10111111111111000000000000000000000000000000000001
           101          1000000000000000000000000000000000001
1111111111110111111111111111111100011111111111111111111111111
        10000000000110000000000000000000000000000000000000001
        10110000011100000000000000000000000000000000000000001
        10010000000000000100000011111111111111111000000100001
111111111011000001110000000000001111111111111111100S000010001
100000000000000011101111111111111           11110000000001001
111101111111110111000000100011111           11100000000000001
11110111  11110111010100100011111           11000111111111111
110000011101010111000000100011111           10001
100000000000000000000000000000001          10001
100000000000000011010100100011111         10001
11000001110101011111011110001            10001
11110111 1110101 111111110001           10001
11111111 1111111 111111110001          1000111111111111111111
                        10001         10001 10000000000000001
                        1000111111111110001110000000000000001
                        1000000000000000000000000000000000001
                        1000000000000000000000000000000000001
                        1000000000000000000000000000000000001
                        1111111111111111111111111111111111111