NO ./path_to_the_north_texture
SO ./path_to_the_south_texture
WE ./path_to_the_west_texture
EA ./path_to_the_east_texture

F 220,100,0
C 225,30,0


        111111111111111111111111
        1000000000011000000000001
        1011000001110000000000001
        1001000000000000000000001
111111111011000001110000000000001
100000000110000011101111111111111
11110111111111011100000010001
11110111111111011101010010001
110000011101010111000000100011111
100000000000000110000001000000001
10000N000000000011010100100011111
1100000111010101111101111000111
11110111 1110101 101111010001
11111111 1111111 111111111111