NO ./texture/bricks.xpm
SO ./texture/planks.xpm
WE ./texture/gravel.xpm
EA ./texture/tilledsoil.xpm

F 48,48,48
C 3,34,76




        11111111111111111111111111111111111111111111111111111
        10000000000110000000000000000000000000000000000000001
        10110000011100000000000000000000000000000000000000001
        10010000000000000100000011111111111111111000000000001
1111111110110000011100000000000011111111111111111000000000001
100000000000000011101111111111111           11111000000000001
111101111111110111000000100011111           10000000000000001
11110111  11110111010100100011111           11111111111111111
110000011101010111000000100011111
100000000000000000000000000000001
100000000000000011010100100011111
110000011101010111110111100N1
11110111 1110101 111111110001
11111111 1111111 111111110001               11111111111111111
                        10001               10000000000000001
                        1000111111111111111110000000000000001
                        1000000000000000000000000000000000001
                        1000000000000000000000000000000000001
                        1000000000000000000000000000000000001
                        1111111111111111111111111111111111111